16
10
1111111111111111
1000000300000001
1000200000020001
1000000000000001
1000002000000001
1000000000000001
1000200000114111
1000000000100001
1000000000100001
1111111111111111
